2222222222222222222
2111111112111111112
2100100012100010012
2100100012100010012
2111111111111111112
2100101000001010012
2111101110111011112
2222100010100012222
2002101117111012002
2222101003001012222
2111111045601111111
2222101000001012222
2002101111111012002
2222101000001012222
2111111110111111112
2100100010100010012
2110111118111110112
2210101000001010122
2111101110111011112
2100000010100000012
2111111111111111112
2222222222222222222
