0000000000000000000
0111111110111111110
0100100010100010010
0100100010100010010
0111111111111111110
0100101000001010010
0111101110111011110
0000100010100010000
0000101117111010000
0000101003001010000
0111111045601111110
0000101000001010000
0000101111111010000
0000101000001010000
0111111110111111110
0100100010100010010
0110111118111110110
0010101000001010100
0111101110111011110
0100000010100000010
0111111111111111110
0000000000000000000