0000000000000000000
0111110110110111110
0101010011100101010
0100111010101110010
0111101111111011110
0101000100010001010
0101111111111111010
0101010101010010100
0111111117111111110
0010001003001000100
0111111045601111100
0010010000000100100
0010011100011100100
0110110110110110110
0100100011100010010
0111110110110111110
0100010100010100010
0111011118111101110
0101010000000101010
0101010111110101010
0111111100011111110
0000000000000000000