0000000000000000000
0111111011101111010
0100001110101010010
0101111011111111110
0101001110101101010
0101011011101000110
0101010010100010010
0101011010101010110
0101001117111111100
0101111003001010110
0100001045601110010
0111111000001000110
0100010111111110100
0101111100101011110
0101010000101010010
0101111110101010110
0100010018101110100
0111110110100011110
0100100100101110010
0100100101100010010
0111111111111111110
0000000000000000000